TTTTTTTTTTTTTTTTTTTTTTTT
T           P          T
T R              TTTTTTT
TTTTTTTT      R  T     T
T      T         P      .
T      P       T       T
T                      T
T    P      T      R   T
T   R   T              T
T  TTTTT      P        T
T      T               T
TTTTTTTTTT   TTTTTTTTTTT
          RRR               .